Paya=Paya
Gerudo=Gherudo
Ganon=Ganninn
Daruk=Dahrewk
Sidon=Sighdonn
Teba=Tiba
Urbosa=Urr-boe-suh
Buliara=Boolee-airah
goro=gohro
Riju=Reejew
Bokoblin=boe-koblin
Bokoblins=boe-koblins
Dorephan=Dorafann
Kaneli=Kih-nelly
Impa=Impuh
Rudania=Rudawnia
Symin=Sighmin
Tulin=Twolin
Dinraal=Din-raal
hm=hmm
sheikah=sheekah
Ramella=Rahmella
hinox=highnox
Cotera=Ko-terra
Farosh=FaRowsh
Bosphoramous=Bosphoramus
Zonai=Zohnai
comradery=comraderie
Cryonis=Cry-oniss
Hmph=humph
Mikau=Meekow
recoalesced=re-coalesced
sclera=sclaira
sami=sammie
Mido=Meedo
Haiyore=hi-yoray
R'lyeh=Rilyyay
Cthugha=Sithuugyua
Unya=oon-ya
Dreamlands=Dream lands
Innsmouth=Inns Mouth
Nitocris=Nittocris
junpei=joonpei
akihiko=akeeheeko
aigis=eyegis
ryoji=reeojie
kun=koon
yamagishi=yamaggishi
kirijo=kirijoh
natsuki=nattsuki
junpei's=joonpei's
nii=knee
hamuko=ha-moo-ko
hamuko's=ha-moo-ko's
hm=hmm
tch= 
thanatos=thanatose
lucia=loo-see-a
iwatodai=eewatoedye
aki=ahki
kyoko=keeoko
akihiko's=akeeheekos
hidetoshi=hihdehtoeshi
naginata=nagheenata
shirogane=shiroganay
yakushima=yakuushima
aigis's=eyegis's
naoto=now-ohto
nii-san=knee-san
minato-kun=minato-koon
takeba=takayba
takeharu=takayharu
hrm=herm
ngh=ungh
café=caffay
cafe=caffey
Déjà=Dayjza
Deja=Dayjza
keisuke=keisukay
hmph=humph
chie=chee-eh
hagakure=hagakureh
what'd=whatid
dumbass=dumb ass
megidola=meggidola
melchizedek=melchee-zedek
digimon=digimonn
lucia=luseeah
bunkichi=bunkiychee
uhh=ahh
uhhh=ahh
hayase=ha-ya-seh
aww=aw
magarudyne=ma-garudyne
alleyway=alley way
ya know=y'know
chrom=chrawm
lucina=looseena
lon'qu=lon-cue
vaike=vike
plegian=plegeean
chrom's=chrawm's
gaius=guyus
ylisse=eleese
plegians=plegeeans
taguel=tagwell
plegia=plegeea
libra=leebra
henry=henree
gangrel=gang grell
regna=regg nah
the themis=themiss
lucina's=luceena's
chezni=Chehzz-knee
chezni's=Chehzz-knee's
gabnid=gab-nid
fiorla=fee-orr-la
jarmlu=jarm-loo
resutaur=ressu-taur
liluette=lee-loo-ette
luliette=loo-lee-ette
raya=ra-ya
chez=chehz
reiyold=rey-old
packrat=pack-rat
Kaymat=Kay-matt
ribbit=ribbitt
Naskuot=Nas-kwot
Saskuot=Sas-kwot
fluttershy=flutter-shy
nopony=no pony
twi=twai
azalea=ahzaylea
balthier=baltheer
balthier's=baltheer's
strahl=strawl
ffamran=famrin
ashe's=ashes
die=dye
gaj=gadge
hylians=highlians
hylian=highlian
hylia=highlia
raigan=ryegan
raigans=ryegans
EC-1101=E C Eleven Oh One
somepony= some-pony
psychoshy=psycho shy
pegasi=payga-sigh
Xanthe=Zanth
manehattan=mane hattin
vegeta=vegeeta
vegeta's=vegeeta's
saiyan=sayin
saiyans=sayins
dende=denday
namekian=nehmekeean
ultrazord=ultra-zord
lyradile=Lyra-Dyle
cybele=Sibilee
mook=mooook
mooks=moooks
demorphs=dee morphs
Naoki=nowki
demifiend=demi-fiend
hikawa=hee-kawa
chiaki=chee-acky
naoki's=nowkies
demifiend's=demi-fiends
yhvh=Yah-Way
dante=dann-tayy
fódlan=phode-lyn
fodlan=phode-lyn
fÃ³dlan=phode-lyn
Isamu=Ihsawmu
Uzume=Uzumay
Megacetaphen=Mega-cetaphen
Gemini=Gem-in-eye
Pisces=Pie-Sees
D-caf=Decaf
Saskuot=Sass-Kwot
Nuzlocke=Nuzz Lock
atm=A-T-M
andonuts=ando-nuts
giygas=guygis
carpainter=car-painter
faithkeeper=faith-keeper
carpainter's=car-painter's
iq=I-Q
Dukas=Ducass
Gig=Gigg
sweetleaf=sweet-leaf
Gabus=Gaboos